000000000-
000030000-
000030000-
033353330-
000030030-
000030030-
033333330-
030000000-
033330000-
000040000-
000040000-
777141777-
777141777-
777141777-
777141777-
777141777-
777141777-
777141777-
777141777-
000040000-
033330000-
030000000-
030033330-
030030030-
030030030-
033333330-
000040000-
000040000-
777141777-
777141777-
777141777-
777141777-
777141777-
777141777-
777141777-
777141777-
777141777-
777141777-
000040007-
000033307-
033300307-
030300307-
030300307-
030300307-
033333307-
000400007-
000400007-
000400007-
000400007-
000444007-
000004007-
700044007-
700440007-
770400007-
222222227-
000400007-
000400007-
777477777-
777477777-
777477777-
777477777-
777477777-
777477777-
000400077-
004440077-
004640077-
004440077-
000000077